50,50 100,100
WWWWWWWDDDWWWWWW
W______________W
W______________W
W______________W
W______________W
W____WWW_WWW___W
W____W_____W___W
R____W_____W___L
R_______P______L
R____W_____W___L
W____W_____W___W
W____WWW_WWW___W
W______________W
W______________W
W______________W
WWWWWWWUUUWWWWWW
