3,5 4,5 5,5 6,10 7,10 8,10, 9,10, 10,15 15,20 20,20
WWWWWWWDDDWWWWWW
W______________W
W______________W
W______________W
W______________W
W______________W
W______________W
R______________L
R_______P______L
R______________L
W______________W
W______________W
W______________W
W______________W
W______________W
WWWWWWWUUUWWWWWW
