5,5 10,10 15,15 20,20 30,30 50,50
WWWWWWWDDDWWWWWW
W______________W
W______________W
W______________W
W___WW_____WW__W
W___W_______W__W
W______________W
R______________L
R_______P______L
R______________L
W______________W
W___W_______W__W
W___WW_____WW__W
W______________W
W______________W
WWWWWWWUUUWWWWWW
